%%%%%%%%%%%%%%%%%%%%%%
%  %%%......% %      %
%  . %%%%%% %    %%% %
%%%%       P  % .....%
% ...    %%%% %% %%%%%
% %%%%     ...   %   %
%  ..... %%%     %%% %
%%    %%%%   %%%     %
%.......... %%%  ..  %
%%%%%%%%%%%%%%%%%%%%%%